[ |;f    ]
[ |      ]
[ |      ]
[ |;;A;;d]
[ |      ]
[ |;s    ]
[ |;d|A  ]
