[ |;f  ]
[ |    ]
[ |    ]
[ |;;;d]
[ |    ]
[ |;s  ]
[ |    ]
